1111111111111111
111E0000P0000111
1110000000000111
1000001111M00001
1000M00000000001
11100000M0000111
111CCCCCCCCCC111
1111111111111111
